11111111111111111111111111111
1E000P01111111111111111110001
11000000111111111111111110001
100C00C0000000000000000000001
100000C0111111111111111110001
1CCCCC0111111111111111110C011
11111111111111111111111111111