11111111111111111111111111111
1000000000000000000P000000001
10000000000000000000000000001
10000000000000000000000000001
10011111111111111111111111111
1Mm000C000000C0000000000000E1
11111111111111111111111111111