11111111111111111111111111111
111111110000mm00000P000000001
10mmmmMmm111Cm000000000000001
10m11111mmmmmm000000000000001
10mmm111111111111111111111111
1000mmmmmCCCCCCCCCCCCCCC000E1
11111111111111111111111111111