11111111111111111111111111111
1E000P01111111111111111110001
11000000111111111111111110001
10000C00000000000000000000001
10000000111111111111111110001
10000001111111111111111110001
11111111111111111111111111111