11111111111
1EC00000001
1CP00000001
10000000001
10000000001
10000000001
11111111111