11111111111111111111111111111
1000000000000000mmmmP00000001
100000000000000mm00m000000001
1000000000000000000m000000001
1000000000000000mmmM000000001
100000C000000C0000000000000E1
11111111111111111111111111111